##########
#M..#..M.#
#....C...#
#M.....#.#
#....O...#
##########